11111111111111111111111111111111111111111111111111111111111111111111111111111111111111111111111111111111111111111111111111111111111111111111111111111111111111111111111111111111111111111111111111111111111111111111111111111111111111
11111111111111111222222222222222222222222222222222222222222222222222222222222222222222222222222222222222111111111111111111111111111111111222222222222222222222222222222222222222222222222222221111111111111111111111111111111111111111
11111111111222222222222222222222222222222222222222222222222222222222222222222222222222222222222222222222222222222211111111111222222222222222222222222222222222222222222222222222222222222211111111111111111111111111111111111111111111
11111111111111222222222222222223333333333333333333333333333333333333333333333333332222222222222222222222222222222222211111112222222222222222222222222222222222333333333333333333222222222222221111111111111111111111111111111111111111
11111111222222222223333333333333333333333333333333333333333333333333333333333333333333333333322222222222222222222221111111111222222222222222222333333333333333333333333333333333333333222222222222222222222222221111111111111111111111
11111112222222333333333333333333333333333333344444444444444444444444443333333333333333333333333333322222222222222111111111112222222222222333333333333333333333333333333333333333333333333333333332222222222222222222211111111111111111
11111111222222333333333333333333333333333334444444444444444444444444444443333333333333333333333333333332222222221111111111112222222222222333333333333333333333333333333333333333333333333333333333333333322222222222222222211111111111
11111111222222222333333333333333333333333444444444444444444444444444444444444444333333333333333333333333332222221111111112222222222222223333333333333333333333333333333333333444444444444444444444433333322222222222222222211111111111
11111111122222222233333333333333333333334444444444444444444444444444444444444444444333333333333333333333333322222111111112222222222222233333333333333333333333333333333333444444444444444444444444444444333322222222222111111111111111
11111111112222223333333333333333333333344444444444444444443333333333344444444444444333333333333333333333333322222221111122222222233333333333333333333333333333333333333444444444444444444444444444433333333333333222111111111111111111
11111111122222222233333333333333333333334444444444444444444443333333444444444444444333333333333333333333333322222222111122222223333333333333333333333333333333333333334444444444444444444444444444443333333333333322221111111111111111
11111111122222222233333333333333333333334444444444444444444433333333344444444444444433333333333333333333333322222222111111222222333333333334444444444333333333333333333333344444444444444444444444443333333333333322221111111111111111
11111111112222222233333333333333333333344444444444333334444443333333344444444444444333333333333333333333333222222222111111222222333333333334444444443333333333333333333333333334444444444444444444444444333333333333111111111111111111
11111111122222222223333333333333333333444444444333333344444443333333333444444444444444333333333333333333333322222221111112222223333333333344444444444444333333333344444443333333344444444444444443333333333333333311111111111111111111
11111111112222222233333333333333333333344444443333333344444433333333333444444444444444433333333333333333333333322222111112222333333333334444444443333444444333333333444444444333444444444444444443333333333333333333111111111111111111
11111111122222222333333333333333333444444444333333333333344443333333344444444443334444444333333333333333333333322222111122222233333333333344444443333344444333333333333344444333333344444444444444333333333333333333111111111111111111
11111111222222222233333333333333333333334444444333333333444444444433344444444333333334444444433333333333333333333322111122333333333333344444444333333333344443333333333333344444444444444444444444444333333333333333333111111111111111
11111111222222222333333333333333333333333333444444444444444444444444444444433333333333333333333333333333333333333333111111333333333333333344444444433333333333333333333333333344444444444444444444433333333333333333333111111111111111
11111111222233333333333333333333333333333333333344444444444444444444444443333333333333333333333333333333333333333333331111113333333333333344444444433333333333333333333333333333344444444444444444433333333333333333333311111111111111
11111111112233333333333333344444444433333333355555555555555554444444444333333333333333333333333333333333333331111111111111333333333333333333334444444433333333333333333333333444444444444444444444333333333333333333333333111111111111
11111111122333333333333333333333444444444445555555555555555555555444444443333333333333333333333333333333333111111111111133333333333333333333333333444444444444333333333333333444444444444444444444444443333333333333333333311111111111
11111111111333333333333333333333333444444444444555555555555555544444444444444333333333333333333333333111111111111111113333333333333333333333333333333344444444444555555555555533333333334444444444444444444333333333333333333311111111
11111111133333333333333333333333333333444444444455555555555544444444443333333333333444444444444333333111111111111333333333333333333333333334444444444444333334444445555555555555555444444444444433333333333333333333333333333111111111
11111111333333333333333333333334444444444444455555555555554444444444444433333333444444444433333333333333333311111111111111111333333333333333333444444444433333334445555555555555555555555544444444444444444433333333333333333311111111
11111112222222222333333333333333333344444444455555555555444444444444444444444444444444444443333333333333333111113333333333333333333333333333444444444444444444444444455555555555553333333333444444444444444333333333333333333322211111
11111112222222222222333333333333333333334444555555555555555555544444444333333444444444433333333333311111111112223333333333333333333333333333333333444444444445555555555555555555555333333333344444444444433333333333333333333222211111
11111122222222222223333333333333344444444455555555551555555555444444444433333344444444333333333333333331111222223333333333333333333333333333333344444444444444555555555555555553333333333444444444444443333333333333333333333332221111
11111122222222222233333333333333333444444455555555511555555555544444444433333344444444444333333333333333111222223333333333333333333333333333344444444433333344455555555555555555553333344444444444444444444443333333333333332222221111
11111122222222223333333333333333333334444444555555115555555555444444444444444444444443333333333333333333311111333333333333333333333333333333333444444444433444444455555555555555533333333334444444444444433333333333333333333322221111
11111222222222222333333333333333333444444444444551111155555555555555555555444444444433333333333333311111111113333333333333333333333333333333333444444443333333344445555555555555555554444444444444443333333333333333333333333333311111
11111112222222223333333333333333334444444444445551155111555555555555555544444444444333333333333333333111111111111111111111113333333333333333344444444443333333333333555555555555555555555555544444444444444433333333333333333333111111
11111122222222222233333333333333333334444444555511555511155555555555554444444444444444443333333333331111111111111111111111111111133333333333333333444444444443355555555555555555555555555544444444444444444444444433333333333333331111
11111222233333333333333333344444433333334444451115555555111111111111144444444444444444444433333333331113333333333444441111133333333333333333444333444444444555555555555555555555555555555555555444444444444443333333333333333333331111
11111112222333333333333333334444444333444444551155555544444411144444444444444444444443333333333322211133333333444444411111333333333333334444444444444444444444444445555555555555554444444455555555554444433333333332222222333333111111
11111111111111111111111144444444444444444555551155444444444441114444433333344444444433333332222221111333334444444444444411113333333334444444444433333333334444444555555544444444444444455555555554444444444444442222222222222333311111
11111111111111111444444444443333333444455554444444444444444444411111333333333333333333333322222111111111444444444444444441113333334444444444433333333333333334444444455555544444444455555554444444444455555554444443333333333333111111
11111113333333334444444444444443333333355555555555444444111111111114444444444555555555544444444441114444444444443333331111111111111444444444111111133333333444444111111155555555444555555555554444455555555444444444444444444441111111
11111133333334444444444333334444444555555554444445555444444111114444444555555555544444555555551111111115555544444433311133333331111114444441111333344444444444111111115555555555555555555555544444444445555554444444333334444441111111
11113333333344444444444433344444444445555544444444455554444441144444455555554444444444444555555555511155555555544444111133333333311111111111113333333344444444444111155555555555555555555555444444444444444444444443333333333444411111
11111333334444444444443333333344444555555555554444444444444441111155555555555555544444445555555511115555554444444444411113333333333333333333333333334444444444444441111555555555555555555444444444443333333333333333333333333333411111
11133333344444444333333344444444555555555555555555555444444111331111555555555555555444455555511111555554444444444441111111111333333333333333333333444444444444441111155555555555554444444444444444444444433333331111111111111111111111
13333333444444433333334444444444444455555555555555555554444111333111555555555555555555555544441155555554444444444444444444333333333333333333355555544444444444411133333333344444444444444444444444443333333331111111111111111111111111
13333333344444443333333344444444444455555555555544444444411113333311555555555555555555555444441111555555333334444444444444444443333333355555555555554444444444333333333333333443333444444433333334444441111111111111111111111111111111
11333333334444444433333333333444444444444444444444444411111133333311111113333333333555444444444411111555553333344444444444444433333333333555555554444444333333333333333333444444333333333333333331111111111111111111111111111111111111
11133333333444444444333333344444444433334444444444443331113333333331113333333344445555544444444444411111111333334444444444433333355555555555444444444444444433333333333334444333333333333333331111111111111111111111111111111111111111
11133333333333344444433334444444333333333444444443333333111111111111133333444444444455555554444445555555551113333333333444444433335555555553333333344444444443333333444444444444444443333333333333311111111111111111111111111111111111
11111111333333333333333334444444333333333333333333333333333111333333333333334444444444555555555555555544444114333333333333444444444455553333333333333444444444444444444443334444444444443333333111111111111111111111111111111111111111
11111111133333333333333444444444444444433333333333333333111111113333333333333334444444444444555554444444433311333333334444444444444444444443333333333333334444444444433333333444444444333333333333333111111111111111111111111111111111
11111111223333333333334444444443333333333333333222223333333331111333333333334444444444444444444444444443333311133331111114444444444444333333333333333333333444333333333333333344433333333333333331111111111111111111111111111111111111
11112222222333333333333333333333333222222222222222222221111111111111333333333333334444444444444333333333333333333333111444444444444444444433333333333344444444444333333333444444444333333331111111111111111111111111111111111111111111
11222222233333333333333333333322222222221111111111111111111111111111111133333333333333333333333333333333333333311111111111111114444444444444444444444444444444444444444444444444333333333311111111111111111111111111111111111111111111
11112222222222222222222222222222222111111111111111111111111111111111111111111111111333333333333333333311111111111111111111111111111111111111444444444444444444444444444441111111111111111111111111111111111111111111111111111111111111
11111122222222222222222222222211111111111111111111111111111111111111111111111111111111111111111111111111111111111111111111111111111111111111111111111111111111111111111111111111111111111111111111111111111111111111111111111111111111
11111111111222222222222211111111111111111111111111111111111111111111111111111111111111111111111111111111111111111111111111111111111111111111111111111111111111111111111111111111111111111111111111111111111111111111111111111111111111
11111111111111111111111111111111111111111111111111111111111111111111111111111111111111111111111111111111111111111111111111111111111111111111111111111111111111111111111111111111111111111111111111111111111111111111111111111111111111